vim#r1char()	得到一个 ASCII 值对应的字符
vim#char2nr()	得到一个字符的 ASCII 码值
vim#str2nr()	转换一个字符串为数字
vim#str2float()	转换一个字符串为浮点数
vim#printf()	根据%转换符格式化一个字串
vim#escape()	返回一个字符串以\转义符表达式的形式
vim#shellescape()	返回一个给 shell 命令使用的转义字符串
vim#fnameescape()	返回一个给 Vim 命令使用的转义后的文件名字符串
vim#tr()	将给定串的字符从一个字符集合转换到对应的另一个字符集合
vim#strtrans()	将一个字符串转换为可显示形式 a
vim#tolower()	将一个字符串转换为小写
vim#toupper()	将一个字符串转换为大写
vim#match()	返回一个搜索在一个字符串中出现的位置
vim#matchend()	同 match(),但从后往前搜索
vim#matchstr()	同 match,但返回匹配到的目标串
vim#matchlist()	同 matchstr,同时将匹配的子模式一并返回
vim#stridx()	一个子串初次出现在母串中的位置
vim#strridx()	一个子串最后一次出现在母串中的位置
vim#strlen()	求字符串长度
vim#substitute()	字符串替换
vim#submatch()	得到一次substitute操作中的匹配到的一个子模式b
vim#strpart()	得到一个字符串的子串
vim#expand()	扩展特殊的关键字
vim#iconv()	转变文字编码
vim#byteidx()	返回给定字符在字串中的字节索引
vim#repeat()	将给定定串重复多次
vim#eval()	求值一个字符串表达式
vim#get()	得到指定下标的列表项,下标越界也不报错
vim#len()	得到一个列表中列表项的个数
vim#empty()	检查一个列表是否为空
vim#insert()	向列表中新插入一项
vim#add()	向列表追加一项
vim#extend()	向列表追加另一列表
vim#remove()	从列表中移除一或多项
vim#copy()	浅复制一个列表
vim#deepcopy()	完全复制一个列表
vim#filter()	从列表中移除指定项
vim#map()	根据指定规则改变每个列表项的值
vim#sort()	将一个列表排序
vim#reverse()	将一个列表反序
vim#split()	将一个字串分割为一个列表
vim#join()	将一个列表中的各项粘合成一个字串
vim#range()	返回一个数字序列形成的列表
vim#string()	返回一个列表的字串表示形式
vim#call()	以一个列表中各项为参数调用一个函数
vim#index()	返回列表中某个列表项的索引
vim#max()	求各个列表项的最大值
vim#min()	求各个列表项的最小值
vim#count()	统计列表中某一列表项出现的次数
vim#repeat()	将列表重复多次
vim#get()	得到字典中指定健的条目的值,如果指定健不存在也不报告错误
vim#len()	得到字典条目的个数
vim#has_key()	检查字典中是否包含某个指定健值的条目
vim#empty()	检查字典是否为空
vim#remove()	从字典中移除某个指定健的条目
vim#extend()	向一个字典中加入另一个字典的条目
vim#filter()	根据指定条件移除字典中匹配的条目
vim#map()	按指定规则改变字典中的每个条目
vim#keys()	得到字典中各个健形成的列表
vim#values()	得到字典中各个值形成的列表
vim#items()	得到字典中以每个键-值对组成的列表的列表
vim#copy()	浅复制一个字典
vim#deepcopy()	完全复制一个字典
vim#string()	字典的字符串表示
vim#max()	求字典中的最大值
vim#min()	求字典中的最小值
vim#count()	统计一个值出现在次数
vim#float2nr()	浮点数转换为整数
vim#abs()	对浮点数求绝对值(同样适用于整数)
vim#round()	四舍五入a
vim#ceil()	向上舍入
vim#floor()	向下舍入
vim#trunc()	截除小数点后的部分
vim#log10()	以1为底的对数
vim#pow()	x 的y次方幂
vim#sqrt()	求平方根
vim#sin()	三角函数sine
vim#cos()	三角函数cosine
vim#atan()	三角函数
vim#type()	变量的类型,返回0为数字,1为字符串a
vim#islocked()	检查变量是否被锁住
vim#function()	由指定名字的函数返回该函数的引用
vim#getbufvar()	得到指定缓冲中的变量
vim#setbufvar()	为指定缓冲区设定变量值
vim#getwinvar()	得到指定窗口的变量
vim#gettabvar()	得到指定标签页的变量
vim#gettabwinvar()	得到指定窗口和标签页中的变量
vim#setwinvar()	为指定窗口设置变量
vim#settabvar()	为指定的标签页设置变量
vim#settabwinvar()	设置指定窗口和标签页中的变量
vim#garbagecollect()	执行内存的自动垃圾回收
vim#col()	得到光标或一个mar 所在的列号
vim#virtcol()	得到光标或一个mark所在屏幕上的列位置
vim#line()	得到光标或一个mark所在的行号
vim#wincol()	当前光标在当前窗口坐标中的列号a
vim#winline()	当前光标在当前窗口坐标中的行号
vim#cursor()	将光标置于指定的行列
vim#getpos()	得到指定的光标或位置标记等的位置信息
vim#setpos()	设置指定的光标或位置标记等的位置信息
vim#byte2line()	得到该文件中第N个字节位于第几行
vim#line2byte()	同上面的相反,求得指定行的首字符位于文件中的字节偏移
vim#diff_filler()	得到diff模式下指定行前面被填充的行数
vim#getline()	从当前缓冲区中得到指定行的内容,或是存储多行文本的列表
vim#setline()	将缓冲区某行的内容替换为指定内容
vim#append()	将指定的行,或指定的列表中的各行追加到当前缓冲区中由参数指定的行之后
vim#indent()	得到指定行的缩进量
vim#cindent()	根据C语言风格得到的指定行以空格个数统计的缩进量
vim#lispindent()	根据Lisp语言风格得到的指定行以空格个数统计的缩进量
vim#nextnonblank()	返回指定行及指定行之后的第一个非空行
vim#prevnonblank()	返回指定行及指定行之前的第一个非空行
vim#search()	查找下一个正则表达式
vim#searchpos()	查找一个模式的匹配
vim#searchpair()	在由开始/中间/结束三元素组成的语言结构中查找这三种元素
vim#searchpairpos()	同searchpair()但返回值为行号和列索引组成的列表
vim#searchdecl()	得到一个变量的声明所在的行
vim#glob()	扩展文件名通配符
vim#globpath()	同上,但可以指定一系列的目录
vim#findfile()	在指定的目录列表中查找文件
vim#finddir()	在指定的目录列表中查找目录
vim#resolve()	返回MS-Windows上一个链接所指向的目标
vim#fnamemodify()	返回文件名的各种形式 a
vim#pathshorten()	返回一个路径各部分被缩简为单个字母的路径名
vim#simplify()	不改变路径本身的情况下简化其表示
vim#executable()	检查一个可执行程序是否存在
vim#filereadable()	检查文件的可读性
vim#filewritable()	检查文件是否可写
vim#getfperm()	返回文件的许可位
vim#getftype()	返回文件的类型
vim#isdirectory()	检查一个目录是否存在
vim#getfsize()	得到文件大小
vim#getcwd()	返回当前工作目录
vim#haslocaldir()	判断当前窗口是否设定了本地目录
vim#tempname()	得到一个临时文件名
vim#mkdir()	创建新目录
vim#delete()	删除文件
vim#rename()	文件更名
vim#system()	执行一个SHELL命令
vim#hostname()	当前系统的主机名
vim#readfile()	将一个文件的各行读入一个列表
vim#writefile()	将一个列表中的各行写入文件
vim#getftime()	得到指定文件的最后修改时间
vim#localtime()	获取当前时间
vim#strftime()	将时间转换为字符串形式
vim#reltime()	得到当前的或已逝的精确时间值
vim#reltimestr()	把reltime()返回的值转换为字串表示
vim#argc()	返回参数列表中的参数个数
vim#argidx()	参数列表中的当前索引号
vim#argv()	返回参数列表中指定索引号的参数
vim#bufexists()	检查一个缓冲区是否存在
vim#buflisted()	检查一个缓冲区是否存在并且位于缓冲区列表中
vim#bufloaded()	检查一个缓冲区是否存在并被载入
vim#bufname()	返回指定缓冲区号所对应的缓冲区名字
vim#bufnr()	返回指定缓冲区名字所对应的缓冲区号
vim#tabpagebuflist()	得到指定页签中的缓冲区列表
vim#tabpagenr()	得到指定页签的编号
vim#tabpagewinnr()	对指定页签的 winnr()函数
vim#winnr()	返回当前窗口的窗口号
vim#bufwinnr()	得到指定缓冲区所在的窗口号,没有对应窗口时返回-1
vim#winbufnr()	返回指定窗口中所编辑的缓冲区的号码
vim#getbufline()	从指定缓冲区中取得指定行作为列表变量返回
vim#getcmdline()	得到当前的命令行
vim#getcmdpos()	得到命令行中当前光标的位置
vim#setcmdpos()	设置命令行中当前光标的位置
vim#getcmdtype()	返回当前命令的类型
vim#getqflist()	将quickfix窗口中各项作为列表返回
vim#setqflist()	修改一个quickfix列表
vim#getloclist()	将location窗口中的各项作为列表返回 a
vim#setloclist()	修改一个 location 列表
vim#omplete()	设置找到的匹配项
vim#complete_add()	添加一个匹配项
vim#complete_check()	检查当前补全是否应该被放弃
vim#pumvisible()	检查弹出菜单是否已显示
vim#foldclosed()
vim#folding-functions 检查指定行是否位于一个处于关闭状态的折行内
vim#foldclosedend()	同上,返回的是折行的尾行行号
vim#foldlevel()	返回指定行的折行层级,没有定义折行时返回0
vim#foldtext()	生成一个关闭的折行所显示的文本 a
vim#foldtextresult()	得到一个折叠起来的折行的显示文本
vim#clearmatches()	清除由matchadd()和:match命令定义的所有匹配
vim#getmatches()	获取由matchadd()和:match命令定义的所有匹配
vim#hlexists()	检查一个语法高亮项是否存在
vim#hlID()	返回一个语法高亮项的ID
vim#synID()	返回指定位置的语法ID
vim#synIDattr()	返回某语法ID的指定属性
vim#synIDtrans()	得到某语法项最终应用了其颜色定义的那种语法的ID
vim#diff_hlID()	得到diff下指定位置的高亮ID
vim#matchadd()	定义一个语法高亮的模式(一个匹配)
vim#matcharg()	得到:match的参数信息
vim#matchdelete()	删除一个由matchadd()或:match命令定义的匹配
vim#setmatches()	恢复由getmatches()保存的匹配列表
vim#spellbadword()	定义当前光标处或其后的拼写有误的字词
vim#spellsuggest()	返回建议的改正词条
vim#soundfold()	返回读音近似的词
vim#histadd()	向历史列表中加入条目
vim#histdel()	从历史列表中删除条目
vim#histget()	从历史列表中得到一个条目
vim#histnr()	得到历史列表中记录个数
vim#browse()	打开一个文件选择对话框
vim#browsedir()	打开一个目录选择对话框
vim#confirm()	让用户确认一组选择
vim#getchar()	让用户输入一个字符
vim#getcharmod()	得到最后一次输入字符时的修饰键
vim#input()	从用户那要一行内容
vim#inputlist()	让用户从一个列表中选取其中一项
vim#inputsecret()	同上,但不回显输入的内容
vim#inputdialog()	让用户在一个对话框里输入
vim#inputsave()	保存并清空预输入的内容
vim#inputrestore()	恢复由inputsave()保存下的预输入内容
vim#serverlist()	返回服务器名字列表
vim#remote_send()	向指定服务器发送命令字符
vim#remote_expr()	在服务器求值一个表达式
vim#server2client()	向客户端发送一个回应
vim#remote_peek()	检查是否收到来自服务器的回应
vim#remote_read()	从服务器读取回应信息
vim#foreground()	将Vim窗口移到前台
vim#remote_foreground()	将Vim 服务器窗口移至前台
vim#winheight()	返回指定窗口的高度,单位为字符
vim#winwidth()	返回指定窗口的宽度,单位为字符
vim#mode()	返回当前的编辑模式
vim#visualmode()	返回最近一次使用的Visual子模式
vim#hasmapto()	检查是否有一个键被定义为指定的内容
vim#mapcheck()	检查一个映射是否存在
vim#maparg()	返回一个映射的右部,即它所被映射的内容
vim#exists()	检查一个变量或函数等是否被定义
vim#has()	检查当前的 Vim 是否支持某个特性
vim#cscope_connection()	检查是否存在某个cscope连接
vim#changenr()	得到最近一次修改的编号
vim#did_filetype()	检查是否一个设置文件类型的自动命令已被执行过
vim#eventhandler()	检查当前脚本是否因事件触发而被调用
vim#libcall()	调用外部共享库中的一个函数
vim#libcallnr()	同上,但用于返回int的函数
vim#getreg()	返回寄存器的内容
vim#getregtype()	返回寄存器中所保存的文本的类型
vim#setreg()	设置一个寄存器的内容和内容的类型
vim#taglist()	返回匹配的tags 列表
vim#tagfiles()	返回tags文件列表
vim#mzeval()	求值MzScheme的表达式
vim#variable#b:name	variable local to a buffer
vim#variable#w:name	variable local to a window
vim#variabl#eg:name	global variable (also in a function)
vim#variable#v:name	variable predefined by Vim
